"ref","adv","loc","covid","goaltime","cens","ref_pos","ref_pts","ref_gd","ref_gf","ref_ga","adv_pos","adv_pts","adv_gd","adv_gf","adv_ga","ref_ability","adv_ability"
"West Ham","Man City","Home","Pre",90,0,10,52,-3,52,55,1,98,72,95,23,"Not Top 6","Top 6"
"Burnley","Southampton","Home","Pre",63,1,15,40,-23,45,68,16,39,-20,45,65,"Not Top 6","Not Top 6"
"Crystal Palace","Everton","Home","Pre",90,0,12,49,-2,51,53,8,54,8,54,46,"Not Top 6","Not Top 6"
"Watford","Brighton","Home","Pre",90,0,11,50,-7,52,59,17,36,-25,35,60,"Not Top 6","Not Top 6"
"Leicester","Wolves","Home","Pre",90,0,9,52,3,51,48,7,57,1,47,46,"Not Top 6","Not Top 6"
"Newcastle","Arsenal","Home","Pre",90,0,13,45,-6,42,48,5,70,22,73,51,"Not Top 6","Top 6"
"Man United","Chelsea","Home","Pre",18,1,6,66,11,65,54,3,72,24,63,39,"Top 6","Top 6"
"Arsenal","Burnley","Home","Pre",13,1,5,70,22,73,51,15,40,-23,45,68,"Top 6","Not Top 6"
"Brighton","West Ham","Home","Pre",65,1,17,36,-25,35,60,10,52,-3,52,55,"Not Top 6","Not Top 6"
"Everton","Watford","Home","Pre",10,1,8,54,8,54,46,11,50,-7,52,59,"Not Top 6","Not Top 6"
"Southampton","Liverpool","Home","Pre",83,1,16,39,-20,45,65,2,97,67,89,22,"Not Top 6","Top 6"
"Man City","Tottenham","Home","Pre",20,1,1,98,72,95,23,4,71,28,67,39,"Top 6","Top 6"
"Chelsea","Leicester","Home","Pre",7,1,3,72,24,63,39,9,52,3,51,48,"Top 6","Not Top 6"
"Wolves","Man United","Home","Pre",55,1,7,57,1,47,46,6,66,11,65,54,"Not Top 6","Top 6"
"Brighton","Southampton","Home","Pre",90,0,17,36,-25,35,60,16,39,-20,45,65,"Not Top 6","Not Top 6"
"Man United","Crystal Palace","Home","Pre",89,1,6,66,11,65,54,12,49,-2,51,53,"Top 6","Not Top 6"
"Watford","West Ham","Home","Pre",17,1,11,50,-7,52,59,10,52,-3,52,55,"Not Top 6","Not Top 6"
"Liverpool","Arsenal","Home","Pre",41,1,2,97,67,89,22,5,70,22,73,51,"Top 6","Top 6"
"Bournemouth","Man City","Home","Pre",45,1,14,45,-14,56,70,1,98,72,95,23,"Not Top 6","Top 6"
"Tottenham","Newcastle","Home","Pre",90,0,4,71,28,67,39,13,45,-6,42,48,"Top 6","Not Top 6"
"Wolves","Burnley","Home","Pre",90,1,7,57,1,47,46,15,40,-23,45,68,"Not Top 6","Not Top 6"
"Southampton","Man United","Home","Pre",58,1,16,39,-20,45,65,6,66,11,65,54,"Not Top 6","Top 6"
"Leicester","Bournemouth","Home","Pre",12,1,9,52,3,51,48,14,45,-14,56,70,"Not Top 6","Not Top 6"
"Man City","Brighton","Home","Pre",2,1,1,98,72,95,23,17,36,-25,35,60,"Top 6","Not Top 6"
"Newcastle","Watford","Home","Pre",41,1,13,45,-6,42,48,11,50,-7,52,59,"Not Top 6","Not Top 6"
"Burnley","Liverpool","Home","Pre",90,0,15,40,-23,45,68,2,97,67,89,22,"Not Top 6","Top 6"
"Everton","Wolves","Home","Pre",5,1,8,54,8,54,46,7,57,1,47,46,"Not Top 6","Not Top 6"
"Arsenal","Tottenham","Home","Pre",45,1,5,70,22,73,51,4,71,28,67,39,"Top 6","Top 6"
"Liverpool","Newcastle","Home","Pre",28,1,2,97,67,89,22,13,45,-6,42,48,"Top 6","Not Top 6"
"Brighton","Burnley","Home","Pre",51,1,17,36,-25,35,60,15,40,-23,45,68,"Not Top 6","Not Top 6"
"Man United","Leicester","Home","Pre",8,1,6,66,11,65,54,9,52,3,51,48,"Top 6","Not Top 6"
"Tottenham","Crystal Palace","Home","Pre",10,1,4,71,28,67,39,12,49,-2,51,53,"Top 6","Not Top 6"
"Wolves","Chelsea","Home","Pre",69,1,7,57,1,47,46,3,72,24,63,39,"Not Top 6","Top 6"
"Bournemouth","Everton","Home","Pre",23,1,14,45,-14,56,70,8,54,8,54,46,"Not Top 6","Not Top 6"
"Watford","Arsenal","Home","Pre",53,1,11,50,-7,52,59,5,70,22,73,51,"Not Top 6","Top 6"
"Southampton","Bournemouth","Home","Pre",53,1,16,39,-20,45,65,14,45,-14,56,70,"Not Top 6","Not Top 6"
"Leicester","Tottenham","Home","Pre",69,1,9,52,3,51,48,4,71,28,67,39,"Not Top 6","Top 6"
"Man City","Watford","Home","Pre",1,1,1,98,72,95,23,11,50,-7,52,59,"Top 6","Not Top 6"
"Newcastle","Brighton","Home","Pre",90,0,13,45,-6,42,48,17,36,-25,35,60,"Not Top 6","Not Top 6"
"Crystal Palace","Wolves","Home","Pre",46,1,12,49,-2,51,53,7,57,1,47,46,"Not Top 6","Not Top 6"
"West Ham","Man United","Home","Pre",44,1,10,52,-3,52,55,6,66,11,65,54,"Not Top 6","Top 6"
"Chelsea","Liverpool","Home","Pre",71,1,3,72,24,63,39,2,97,67,89,22,"Top 6","Top 6"
"Bournemouth","West Ham","Home","Pre",17,1,14,45,-14,56,70,10,52,-3,52,55,"Not Top 6","Not Top 6"
"Chelsea","Brighton","Home","Pre",50,1,3,72,24,63,39,17,36,-25,35,60,"Top 6","Not Top 6"
"Tottenham","Southampton","Home","Pre",24,1,4,71,28,67,39,16,39,-20,45,65,"Top 6","Not Top 6"
"Wolves","Watford","Home","Pre",18,1,7,57,1,47,46,11,50,-7,52,59,"Not Top 6","Not Top 6"
"Everton","Man City","Home","Pre",33,1,8,54,8,54,46,1,98,72,95,23,"Not Top 6","Top 6"
"Leicester","Newcastle","Home","Pre",16,1,9,52,3,51,48,13,45,-6,42,48,"Not Top 6","Not Top 6"
"Man United","Arsenal","Home","Pre",45,1,6,66,11,65,54,5,70,22,73,51,"Top 6","Top 6"
"Brighton","Tottenham","Home","Pre",3,1,17,36,-25,35,60,4,71,28,67,39,"Not Top 6","Top 6"
"Burnley","Everton","Home","Pre",72,1,15,40,-23,45,68,8,54,8,54,46,"Not Top 6","Not Top 6"
"Liverpool","Leicester","Home","Pre",40,1,2,97,67,89,22,9,52,3,51,48,"Top 6","Not Top 6"
"West Ham","Crystal Palace","Home","Pre",54,1,10,52,-3,52,55,12,49,-2,51,53,"Not Top 6","Not Top 6"
"Arsenal","Bournemouth","Home","Pre",9,1,5,70,22,73,51,14,45,-14,56,70,"Top 6","Not Top 6"
"Man City","Wolves","Home","Pre",90,0,1,98,72,95,23,7,57,1,47,46,"Top 6","Not Top 6"
"Southampton","Chelsea","Home","Pre",30,1,16,39,-20,45,65,3,72,24,63,39,"Not Top 6","Top 6"
"Newcastle","Man United","Home","Pre",72,1,13,45,-6,42,48,6,66,11,65,54,"Not Top 6","Top 6"
"Everton","West Ham","Home","Pre",17,1,8,54,8,54,46,10,52,-3,52,55,"Not Top 6","Not Top 6"
"Chelsea","Newcastle","Home","Pre",73,1,3,72,24,63,39,13,45,-6,42,48,"Top 6","Not Top 6"
"Leicester","Burnley","Home","Pre",45,1,9,52,3,51,48,15,40,-23,45,68,"Not Top 6","Not Top 6"
"Tottenham","Watford","Home","Pre",86,1,4,71,28,67,39,11,50,-7,52,59,"Top 6","Not Top 6"
"Wolves","Southampton","Home","Pre",61,1,7,57,1,47,46,16,39,-20,45,65,"Not Top 6","Not Top 6"
"Crystal Palace","Man City","Home","Pre",90,0,12,49,-2,51,53,1,98,72,95,23,"Not Top 6","Top 6"
"Man United","Liverpool","Home","Pre",36,1,6,66,11,65,54,2,97,67,89,22,"Top 6","Top 6"
"Southampton","Leicester","Home","Pre",90,0,16,39,-20,45,65,9,52,3,51,48,"Not Top 6","Not Top 6"
"Brighton","Everton","Home","Pre",15,1,17,36,-25,35,60,8,54,8,54,46,"Not Top 6","Not Top 6"
"Watford","Bournemouth","Home","Pre",90,0,11,50,-7,52,59,14,45,-14,56,70,"Not Top 6","Not Top 6"
"Burnley","Chelsea","Home","Pre",86,1,15,40,-23,45,68,3,72,24,63,39,"Not Top 6","Top 6"
"Newcastle","Wolves","Home","Pre",37,1,13,45,-6,42,48,7,57,1,47,46,"Not Top 6","Not Top 6"
"Arsenal","Crystal Palace","Home","Pre",7,1,5,70,22,73,51,12,49,-2,51,53,"Top 6","Not Top 6"
"Liverpool","Tottenham","Home","Pre",52,1,2,97,67,89,22,4,71,28,67,39,"Top 6","Top 6"
"Bournemouth","Man United","Home","Pre",45,1,14,45,-14,56,70,6,66,11,65,54,"Not Top 6","Top 6"
"Arsenal","Wolves","Home","Pre",21,1,5,70,22,73,51,7,57,1,47,46,"Top 6","Not Top 6"
"Man City","Southampton","Home","Pre",70,1,1,98,72,95,23,16,39,-20,45,65,"Top 6","Not Top 6"
"West Ham","Newcastle","Home","Pre",73,1,10,52,-3,52,55,13,45,-6,42,48,"Not Top 6","Not Top 6"
"Watford","Chelsea","Home","Pre",80,1,11,50,-7,52,59,3,72,24,63,39,"Not Top 6","Top 6"
"Crystal Palace","Leicester","Home","Pre",90,0,12,49,-2,51,53,9,52,3,51,48,"Not Top 6","Not Top 6"
"Everton","Tottenham","Home","Pre",90,1,8,54,8,54,46,4,71,28,67,39,"Not Top 6","Top 6"
"Chelsea","Crystal Palace","Home","Pre",52,1,3,72,24,63,39,12,49,-2,51,53,"Top 6","Not Top 6"
"Burnley","West Ham","Home","Pre",11,1,15,40,-23,45,68,10,52,-3,52,55,"Not Top 6","Not Top 6"
"Newcastle","Bournemouth","Home","Pre",42,1,13,45,-6,42,48,14,45,-14,56,70,"Not Top 6","Not Top 6"
"Southampton","Everton","Home","Pre",50,1,16,39,-20,45,65,8,54,8,54,46,"Not Top 6","Not Top 6"
"Leicester","Arsenal","Home","Pre",68,1,9,52,3,51,48,5,70,22,73,51,"Not Top 6","Top 6"
"Man United","Brighton","Home","Pre",17,1,6,66,11,65,54,17,36,-25,35,60,"Top 6","Not Top 6"
"Liverpool","Man City","Home","Pre",6,1,2,97,67,89,22,1,98,72,95,23,"Top 6","Top 6"
"West Ham","Tottenham","Home","Pre",73,1,10,52,-3,52,55,4,71,28,67,39,"Not Top 6","Top 6"
"Arsenal","Southampton","Home","Pre",18,1,5,70,22,73,51,16,39,-20,45,65,"Top 6","Not Top 6"
"Bournemouth","Wolves","Home","Pre",59,1,14,45,-14,56,70,7,57,1,47,46,"Not Top 6","Not Top 6"
"Brighton","Leicester","Home","Pre",90,0,17,36,-25,35,60,9,52,3,51,48,"Not Top 6","Not Top 6"
"Crystal Palace","Liverpool","Home","Pre",82,1,12,49,-2,51,53,2,97,67,89,22,"Not Top 6","Top 6"
"Watford","Burnley","Home","Pre",90,0,11,50,-7,52,59,15,40,-23,45,68,"Not Top 6","Not Top 6"
"Man City","Chelsea","Home","Pre",29,1,1,98,72,95,23,3,72,24,63,39,"Top 6","Top 6"
"Newcastle","Man City","Home","Pre",25,1,13,45,-6,42,48,1,98,72,95,23,"Not Top 6","Top 6"
"Burnley","Crystal Palace","Home","Pre",90,0,15,40,-23,45,68,12,49,-2,51,53,"Not Top 6","Not Top 6"
"Chelsea","West Ham","Home","Pre",90,0,3,72,24,63,39,10,52,-3,52,55,"Top 6","Not Top 6"
"Liverpool","Brighton","Home","Pre",18,1,2,97,67,89,22,17,36,-25,35,60,"Top 6","Not Top 6"
"Tottenham","Bournemouth","Home","Pre",21,1,4,71,28,67,39,14,45,-14,56,70,"Top 6","Not Top 6"
"Southampton","Watford","Home","Pre",78,1,16,39,-20,45,65,11,50,-7,52,59,"Not Top 6","Not Top 6"
"Leicester","Everton","Home","Pre",68,1,9,52,3,51,48,8,54,8,54,46,"Not Top 6","Not Top 6"
"Crystal Palace","Bournemouth","Home","Pre",76,1,12,49,-2,51,53,14,45,-14,56,70,"Not Top 6","Not Top 6"
"Burnley","Man City","Home","Pre",89,1,15,40,-23,45,68,1,98,72,95,23,"Not Top 6","Top 6"
"Leicester","Watford","Home","Pre",55,1,9,52,3,51,48,11,50,-7,52,59,"Not Top 6","Not Top 6"
"Man United","Tottenham","Home","Pre",6,1,6,66,11,65,54,4,71,28,67,39,"Top 6","Top 6"
"Wolves","West Ham","Home","Pre",23,1,7,57,1,47,46,10,52,-3,52,55,"Not Top 6","Not Top 6"
"Liverpool","Everton","Home","Pre",6,1,2,97,67,89,22,8,54,8,54,46,"Top 6","Not Top 6"
"Arsenal","Brighton","Home","Pre",50,1,5,70,22,73,51,17,36,-25,35,60,"Top 6","Not Top 6"
"Everton","Chelsea","Home","Pre",5,1,8,54,8,54,46,3,72,24,63,39,"Not Top 6","Top 6"
"Bournemouth","Liverpool","Home","Pre",90,0,14,45,-14,56,70,2,97,67,89,22,"Not Top 6","Top 6"
"Tottenham","Burnley","Home","Pre",5,1,4,71,28,67,39,15,40,-23,45,68,"Top 6","Not Top 6"
"Watford","Crystal Palace","Home","Pre",90,0,11,50,-7,52,59,12,49,-2,51,53,"Not Top 6","Not Top 6"
"Man City","Man United","Home","Pre",85,1,1,98,72,95,23,6,66,11,65,54,"Top 6","Top 6"
"Newcastle","Southampton","Home","Pre",68,1,13,45,-6,42,48,16,39,-20,45,65,"Not Top 6","Not Top 6"
"Brighton","Wolves","Home","Pre",34,1,17,36,-25,35,60,7,57,1,47,46,"Not Top 6","Not Top 6"
"West Ham","Arsenal","Home","Pre",38,1,10,52,-3,52,55,5,70,22,73,51,"Not Top 6","Top 6"
"Liverpool","Watford","Home","Pre",38,1,2,97,67,89,22,11,50,-7,52,59,"Top 6","Not Top 6"
"Burnley","Newcastle","Home","Pre",58,1,15,40,-23,45,68,13,45,-6,42,48,"Not Top 6","Not Top 6"
"Chelsea","Bournemouth","Home","Pre",90,0,3,72,24,63,39,14,45,-14,56,70,"Top 6","Not Top 6"
"Southampton","West Ham","Home","Pre",90,0,16,39,-20,45,65,10,52,-3,52,55,"Not Top 6","Not Top 6"
"Man United","Everton","Home","Pre",77,1,6,66,11,65,54,8,54,8,54,46,"Top 6","Not Top 6"
"Wolves","Tottenham","Home","Pre",67,1,7,57,1,47,46,4,71,28,67,39,"Not Top 6","Top 6"
"Arsenal","Man City","Home","Pre",90,0,5,70,22,73,51,1,98,72,95,23,"Top 6","Top 6"
"Crystal Palace","Brighton","Home","Pre",76,1,12,49,-2,51,53,17,36,-25,35,60,"Not Top 6","Not Top 6"
"Everton","Arsenal","Home","Pre",90,0,8,54,8,54,46,5,70,22,73,51,"Not Top 6","Top 6"
"Bournemouth","Burnley","Home","Pre",90,0,14,45,-14,56,70,15,40,-23,45,68,"Not Top 6","Not Top 6"
"Newcastle","Crystal Palace","Home","Pre",83,1,13,45,-6,42,48,12,49,-2,51,53,"Not Top 6","Not Top 6"
"Man City","Leicester","Home","Pre",30,1,1,98,72,95,23,9,52,3,51,48,"Top 6","Not Top 6"
"Watford","Man United","Home","Pre",50,1,11,50,-7,52,59,6,66,11,65,54,"Not Top 6","Top 6"
"Tottenham","Chelsea","Home","Pre",90,0,4,71,28,67,39,3,72,24,63,39,"Top 6","Top 6"
"Tottenham","Brighton","Home","Pre",53,1,4,71,28,67,39,17,36,-25,35,60,"Top 6","Not Top 6"
"Bournemouth","Arsenal","Home","Pre",35,1,14,45,-14,56,70,5,70,22,73,51,"Not Top 6","Top 6"
"Chelsea","Southampton","Home","Pre",90,0,3,72,24,63,39,16,39,-20,45,65,"Top 6","Not Top 6"
"Crystal Palace","West Ham","Home","Pre",68,1,12,49,-2,51,53,10,52,-3,52,55,"Not Top 6","Not Top 6"
"Everton","Burnley","Home","Pre",80,1,8,54,8,54,46,15,40,-23,45,68,"Not Top 6","Not Top 6"
"Man United","Newcastle","Home","Pre",24,1,6,66,11,65,54,13,45,-6,42,48,"Top 6","Not Top 6"
"Leicester","Liverpool","Home","Pre",90,0,9,52,3,51,48,2,97,67,89,22,"Not Top 6","Top 6"
"Wolves","Man City","Home","Pre",55,1,7,57,1,47,46,1,98,72,95,23,"Not Top 6","Top 6"
"Brighton","Bournemouth","Home","Pre",3,1,17,36,-25,35,60,14,45,-14,56,70,"Not Top 6","Not Top 6"
"Newcastle","Everton","Home","Pre",56,1,13,45,-6,42,48,8,54,8,54,46,"Not Top 6","Not Top 6"
"Southampton","Crystal Palace","Home","Pre",74,1,16,39,-20,45,65,12,49,-2,51,53,"Not Top 6","Not Top 6"
"West Ham","Leicester","Home","Pre",45,1,10,52,-3,52,55,9,52,3,51,48,"Not Top 6","Not Top 6"
"Burnley","Man United","Home","Pre",90,0,15,40,-23,45,68,6,66,11,65,54,"Not Top 6","Top 6"
"Arsenal","Chelsea","Home","Pre",13,1,5,70,22,73,51,3,72,24,63,39,"Top 6","Top 6"
"Liverpool","Wolves","Home","Pre",42,1,2,97,67,89,22,7,57,1,47,46,"Top 6","Not Top 6"
"Brighton","Chelsea","Home","Pre",84,1,17,36,-25,35,60,3,72,24,63,39,"Not Top 6","Top 6"
"Newcastle","Leicester","Home","Pre",90,0,13,45,-6,42,48,9,52,3,51,48,"Not Top 6","Not Top 6"
"Southampton","Tottenham","Home","Pre",17,1,16,39,-20,45,65,4,71,28,67,39,"Not Top 6","Top 6"
"Watford","Wolves","Home","Pre",30,1,11,50,-7,52,59,7,57,1,47,46,"Not Top 6","Not Top 6"
"Man City","Everton","Home","Pre",51,1,1,98,72,95,23,8,54,8,54,46,"Top 6","Not Top 6"
"West Ham","Bournemouth","Home","Pre",17,1,10,52,-3,52,55,14,45,-14,56,70,"Not Top 6","Not Top 6"
"Arsenal","Man United","Home","Pre",8,1,5,70,22,73,51,6,66,11,65,54,"Top 6","Top 6"
"Crystal Palace","Arsenal","Home","Pre",54,1,12,49,-2,51,53,5,70,22,73,51,"Not Top 6","Top 6"
"Chelsea","Burnley","Home","Pre",27,1,3,72,24,63,39,15,40,-23,45,68,"Top 6","Not Top 6"
"Everton","Brighton","Home","Pre",38,1,8,54,8,54,46,17,36,-25,35,60,"Not Top 6","Not Top 6"
"Leicester","Southampton","Home","Pre",14,1,9,52,3,51,48,16,39,-20,45,65,"Not Top 6","Not Top 6"
"Wolves","Newcastle","Home","Pre",14,1,7,57,1,47,46,13,45,-6,42,48,"Not Top 6","Not Top 6"
"Tottenham","Liverpool","Home","Pre",90,0,4,71,28,67,39,2,97,67,89,22,"Top 6","Top 6"
"Bournemouth","Watford","Home","Pre",90,0,14,45,-14,56,70,11,50,-7,52,59,"Not Top 6","Not Top 6"
"Watford","Tottenham","Home","Pre",90,0,11,50,-7,52,59,4,71,28,67,39,"Not Top 6","Top 6"
"Man City","Crystal Palace","Home","Pre",82,1,1,98,72,95,23,12,49,-2,51,53,"Top 6","Not Top 6"
"Southampton","Wolves","Home","Pre",15,1,16,39,-20,45,65,7,57,1,47,46,"Not Top 6","Not Top 6"
"West Ham","Everton","Home","Pre",40,1,10,52,-3,52,55,8,54,8,54,46,"Not Top 6","Not Top 6"
"Newcastle","Chelsea","Home","Pre",90,1,13,45,-6,42,48,3,72,24,63,39,"Not Top 6","Top 6"
"Burnley","Leicester","Home","Pre",56,1,15,40,-23,45,68,9,52,3,51,48,"Not Top 6","Not Top 6"
"Liverpool","Man United","Home","Pre",14,1,2,97,67,89,22,6,66,11,65,54,"Top 6","Top 6"
"Bournemouth","Brighton","Home","Pre",36,1,14,45,-14,56,70,17,36,-25,35,60,"Not Top 6","Not Top 6"
"Crystal Palace","Southampton","Home","Pre",90,0,12,49,-2,51,53,16,39,-20,45,65,"Not Top 6","Not Top 6"
"Everton","Newcastle","Home","Pre",30,1,8,54,8,54,46,13,45,-6,42,48,"Not Top 6","Not Top 6"
"Chelsea","Arsenal","Home","Pre",28,1,3,72,24,63,39,5,70,22,73,51,"Top 6","Top 6"
"Leicester","West Ham","Home","Pre",24,1,9,52,3,51,48,10,52,-3,52,55,"Not Top 6","Not Top 6"
"Man United","Burnley","Home","Pre",90,0,6,66,11,65,54,15,40,-23,45,68,"Top 6","Not Top 6"
"Wolves","Liverpool","Home","Pre",51,1,7,57,1,47,46,2,97,67,89,22,"Not Top 6","Top 6"
"West Ham","Liverpool","Home","Pre",90,0,10,52,-3,52,55,2,97,67,89,22,"Not Top 6","Top 6"
"Leicester","Chelsea","Home","Pre",54,1,9,52,3,51,48,3,72,24,63,39,"Not Top 6","Top 6"
"Liverpool","Southampton","Home","Pre",47,1,2,97,67,89,22,16,39,-20,45,65,"Top 6","Not Top 6"
"Watford","Everton","Home","Pre",10,1,11,50,-7,52,59,8,54,8,54,46,"Not Top 6","Not Top 6"
"West Ham","Brighton","Home","Pre",30,1,10,52,-3,52,55,17,36,-25,35,60,"Not Top 6","Not Top 6"
"Man United","Wolves","Home","Pre",90,0,6,66,11,65,54,7,57,1,47,46,"Top 6","Not Top 6"
"Burnley","Arsenal","Home","Pre",90,0,15,40,-23,45,68,5,70,22,73,51,"Not Top 6","Top 6"
"Tottenham","Man City","Home","Pre",63,1,4,71,28,67,39,1,98,72,95,23,"Top 6","Top 6"
"Everton","Crystal Palace","Home","Pre",18,1,8,54,8,54,46,12,49,-2,51,53,"Not Top 6","Not Top 6"
"Brighton","Watford","Home","Pre",78,1,17,36,-25,35,60,11,50,-7,52,59,"Not Top 6","Not Top 6"
"Wolves","Leicester","Home","Pre",90,0,7,57,1,47,46,9,52,3,51,48,"Not Top 6","Not Top 6"
"Southampton","Burnley","Home","Pre",18,1,16,39,-20,45,65,15,40,-23,45,68,"Not Top 6","Not Top 6"
"Arsenal","Newcastle","Home","Pre",54,1,5,70,22,73,51,13,45,-6,42,48,"Top 6","Not Top 6"
"Chelsea","Man United","Home","Pre",90,0,3,72,24,63,39,6,66,11,65,54,"Top 6","Top 6"
"Man City","West Ham","Home","Pre",30,1,1,98,72,95,23,10,52,-3,52,55,"Top 6","Not Top 6"
"Chelsea","Tottenham","Home","Pre",15,1,3,72,24,63,39,4,71,28,67,39,"Top 6","Top 6"
"Burnley","Bournemouth","Home","Pre",53,1,15,40,-23,45,68,14,45,-14,56,70,"Not Top 6","Not Top 6"
"Crystal Palace","Newcastle","Home","Pre",44,1,12,49,-2,51,53,13,45,-6,42,48,"Not Top 6","Not Top 6"
"Leicester","Man City","Home","Pre",90,0,9,52,3,51,48,1,98,72,95,23,"Not Top 6","Top 6"
"Man United","Watford","Home","Pre",42,1,6,66,11,65,54,11,50,-7,52,59,"Top 6","Not Top 6"
"Arsenal","Everton","Home","Pre",27,1,5,70,22,73,51,8,54,8,54,46,"Top 6","Not Top 6"
"Liverpool","West Ham","Home","Pre",9,1,2,97,67,89,22,10,52,-3,52,55,"Top 6","Not Top 6"
"Brighton","Crystal Palace","Home","Pre",90,0,17,36,-25,35,60,12,49,-2,51,53,"Not Top 6","Not Top 6"
"Bournemouth","Chelsea","Home","Pre",54,1,14,45,-14,56,70,3,72,24,63,39,"Not Top 6","Top 6"
"Newcastle","Burnley","Home","Pre",90,0,13,45,-6,42,48,15,40,-23,45,68,"Not Top 6","Not Top 6"
"West Ham","Southampton","Home","Pre",15,1,10,52,-3,52,55,16,39,-20,45,65,"Not Top 6","Not Top 6"
"Watford","Liverpool","Home","Pre",54,1,11,50,-7,52,59,2,97,67,89,22,"Not Top 6","Top 6"
"Everton","Man United","Home","Pre",3,1,8,54,8,54,46,6,66,11,65,54,"Not Top 6","Top 6"
"Tottenham","Wolves","Home","Pre",13,1,4,71,28,67,39,7,57,1,47,46,"Top 6","Not Top 6"
"Liverpool","Bournemouth","Home","Pre",24,1,2,97,67,89,22,14,45,-14,56,70,"Top 6","Not Top 6"
"Arsenal","West Ham","Home","Pre",78,1,5,70,22,73,51,10,52,-3,52,55,"Top 6","Not Top 6"
"Crystal Palace","Watford","Home","Pre",28,1,12,49,-2,51,53,11,50,-7,52,59,"Not Top 6","Not Top 6"
"Southampton","Newcastle","Home","Pre",90,0,16,39,-20,45,65,13,45,-6,42,48,"Not Top 6","Not Top 6"
"Wolves","Brighton","Home","Pre",90,0,7,57,1,47,46,17,36,-25,35,60,"Not Top 6","Not Top 6"
"Burnley","Tottenham","Home","Pre",13,1,15,40,-23,45,68,4,71,28,67,39,"Not Top 6","Top 6"
"Chelsea","Everton","Home","Pre",14,1,3,72,24,63,39,8,54,8,54,46,"Top 6","Not Top 6"
"Man United","Man City","Home","Pre",30,1,6,66,11,65,54,1,98,72,95,23,"Top 6","Top 6"
"Man City","Arsenal","Home","Post",45,1,1,98,72,95,23,5,70,22,73,51,"Top 6","Top 6"
"Tottenham","Man United","Home","Post",27,1,4,71,28,67,39,6,66,11,65,54,"Top 6","Top 6"
"Watford","Leicester","Home","Post",90,1,11,50,-7,52,59,9,52,3,51,48,"Not Top 6","Not Top 6"
"Brighton","Arsenal","Home","Post",75,1,17,36,-25,35,60,5,70,22,73,51,"Not Top 6","Top 6"
"West Ham","Wolves","Home","Post",90,0,10,52,-3,52,55,7,57,1,47,46,"Not Top 6","Not Top 6"
"Bournemouth","Crystal Palace","Home","Post",90,0,14,45,-14,56,70,12,49,-2,51,53,"Not Top 6","Not Top 6"
"Everton","Liverpool","Home","Post",90,0,8,54,8,54,46,2,97,67,89,22,"Not Top 6","Top 6"
"Man City","Burnley","Home","Post",22,1,1,98,72,95,23,15,40,-23,45,68,"Top 6","Not Top 6"
"Leicester","Brighton","Home","Post",90,0,9,52,3,51,48,17,36,-25,35,60,"Not Top 6","Not Top 6"
"Tottenham","West Ham","Home","Post",64,1,4,71,28,67,39,10,52,-3,52,55,"Top 6","Not Top 6"
"Wolves","Bournemouth","Home","Post",60,1,7,57,1,47,46,14,45,-14,56,70,"Not Top 6","Not Top 6"
"Liverpool","Crystal Palace","Home","Post",23,1,2,97,67,89,22,12,49,-2,51,53,"Top 6","Not Top 6"
"Burnley","Watford","Home","Post",73,1,15,40,-23,45,68,11,50,-7,52,59,"Not Top 6","Not Top 6"
"Southampton","Arsenal","Home","Post",90,0,16,39,-20,45,65,5,70,22,73,51,"Not Top 6","Top 6"
"Chelsea","Man City","Home","Post",36,1,3,72,24,63,39,1,98,72,95,23,"Top 6","Top 6"
"Watford","Southampton","Home","Post",79,1,11,50,-7,52,59,16,39,-20,45,65,"Not Top 6","Not Top 6"
"Crystal Palace","Burnley","Home","Post",90,0,12,49,-2,51,53,15,40,-23,45,68,"Not Top 6","Not Top 6"
"Brighton","Man United","Home","Post",90,0,17,36,-25,35,60,6,66,11,65,54,"Not Top 6","Top 6"
"Bournemouth","Newcastle","Home","Post",90,1,14,45,-14,56,70,13,45,-6,42,48,"Not Top 6","Not Top 6"
"Everton","Leicester","Home","Post",10,1,8,54,8,54,46,9,52,3,51,48,"Not Top 6","Not Top 6"
"West Ham","Chelsea","Home","Post",45,1,10,52,-3,52,55,3,72,24,63,39,"Not Top 6","Top 6"
"Man City","Liverpool","Home","Post",25,1,1,98,72,95,23,2,97,67,89,22,"Top 6","Top 6"
"Leicester","Crystal Palace","Home","Post",49,1,9,52,3,51,48,12,49,-2,51,53,"Not Top 6","Not Top 6"
"Man United","Bournemouth","Home","Post",29,1,6,66,11,65,54,14,45,-14,56,70,"Top 6","Not Top 6"
"Wolves","Arsenal","Home","Post",90,0,7,57,1,47,46,5,70,22,73,51,"Not Top 6","Top 6"
"Chelsea","Watford","Home","Post",28,1,3,72,24,63,39,11,50,-7,52,59,"Top 6","Not Top 6"
"Newcastle","West Ham","Home","Post",17,1,13,45,-6,42,48,10,52,-3,52,55,"Not Top 6","Not Top 6"
"Southampton","Man City","Home","Post",16,1,16,39,-20,45,65,1,98,72,95,23,"Not Top 6","Top 6"
"Tottenham","Everton","Home","Post",24,1,4,71,28,67,39,8,54,8,54,46,"Top 6","Not Top 6"
"Crystal Palace","Chelsea","Home","Post",34,1,12,49,-2,51,53,3,72,24,63,39,"Not Top 6","Top 6"
"Arsenal","Leicester","Home","Post",21,1,5,70,22,73,51,9,52,3,51,48,"Top 6","Not Top 6"
"Man City","Newcastle","Home","Post",10,1,1,98,72,95,23,13,45,-6,42,48,"Top 6","Not Top 6"
"West Ham","Burnley","Home","Post",90,0,10,52,-3,52,55,15,40,-23,45,68,"Not Top 6","Not Top 6"
"Brighton","Liverpool","Home","Post",45,1,17,36,-25,35,60,2,97,67,89,22,"Not Top 6","Top 6"
"Bournemouth","Tottenham","Home","Post",90,0,14,45,-14,56,70,4,71,28,67,39,"Not Top 6","Top 6"
"Everton","Southampton","Home","Post",44,1,8,54,8,54,46,16,39,-20,45,65,"Not Top 6","Not Top 6"
"Watford","Newcastle","Home","Post",52,1,11,50,-7,52,59,13,45,-6,42,48,"Not Top 6","Not Top 6"
"Liverpool","Burnley","Home","Post",34,1,2,97,67,89,22,15,40,-23,45,68,"Top 6","Not Top 6"
"Brighton","Man City","Home","Post",90,0,17,36,-25,35,60,1,98,72,95,23,"Not Top 6","Top 6"
"Wolves","Everton","Home","Post",46,1,7,57,1,47,46,8,54,8,54,46,"Not Top 6","Not Top 6"
"Tottenham","Arsenal","Home","Post",19,1,4,71,28,67,39,5,70,22,73,51,"Top 6","Top 6"
"Bournemouth","Leicester","Home","Post",66,1,14,45,-14,56,70,9,52,3,51,48,"Not Top 6","Not Top 6"
"Man United","Southampton","Home","Post",20,1,6,66,11,65,54,16,39,-20,45,65,"Top 6","Not Top 6"
"Burnley","Wolves","Home","Post",90,1,15,40,-23,45,68,7,57,1,47,46,"Not Top 6","Not Top 6"
"Man City","Bournemouth","Home","Post",6,1,1,98,72,95,23,14,45,-14,56,70,"Top 6","Not Top 6"
"Newcastle","Tottenham","Home","Post",56,1,13,45,-6,42,48,4,71,28,67,39,"Not Top 6","Top 6"
"Arsenal","Liverpool","Home","Post",32,1,5,70,22,73,51,2,97,67,89,22,"Top 6","Top 6"
"Crystal Palace","Man United","Home","Post",90,0,12,49,-2,51,53,6,66,11,65,54,"Not Top 6","Top 6"
"Southampton","Brighton","Home","Post",66,1,16,39,-20,45,65,17,36,-25,35,60,"Not Top 6","Not Top 6"
"West Ham","Watford","Home","Post",6,1,10,52,-3,52,55,11,50,-7,52,59,"Not Top 6","Not Top 6"
"Bournemouth","Southampton","Home","Post",90,0,14,45,-14,56,70,16,39,-20,45,65,"Not Top 6","Not Top 6"
"Tottenham","Leicester","Home","Post",6,1,4,71,28,67,39,9,52,3,51,48,"Top 6","Not Top 6"
"Brighton","Newcastle","Home","Post",90,0,17,36,-25,35,60,13,45,-6,42,48,"Not Top 6","Not Top 6"
"Wolves","Crystal Palace","Home","Post",41,1,7,57,1,47,46,12,49,-2,51,53,"Not Top 6","Not Top 6"
"Watford","Man City","Home","Post",90,0,11,50,-7,52,59,1,98,72,95,23,"Not Top 6","Top 6"
"Man United","West Ham","Home","Post",51,1,6,66,11,65,54,10,52,-3,52,55,"Top 6","Not Top 6"
"Liverpool","Chelsea","Home","Post",23,1,2,97,67,89,22,3,72,24,63,39,"Top 6","Top 6"
"Arsenal","Watford","Home","Post",5,1,5,70,22,73,51,11,50,-7,52,59,"Top 6","Not Top 6"
"Burnley","Brighton","Home","Post",44,1,15,40,-23,45,68,17,36,-25,35,60,"Not Top 6","Not Top 6"
"Chelsea","Wolves","Home","Post",45,1,3,72,24,63,39,7,57,1,47,46,"Top 6","Not Top 6"
"Crystal Palace","Tottenham","Home","Post",53,1,12,49,-2,51,53,4,71,28,67,39,"Not Top 6","Top 6"
"Everton","Bournemouth","Home","Post",41,1,8,54,8,54,46,14,45,-14,56,70,"Not Top 6","Not Top 6"
"Leicester","Man United","Home","Post",90,0,9,52,3,51,48,6,66,11,65,54,"Not Top 6","Top 6"
"Newcastle","Liverpool","Home","Post",1,1,13,45,-6,42,48,2,97,67,89,22,"Not Top 6","Top 6"
"Man City","West Ham","Away","Pre",25,1,1,98,72,95,23,10,52,-3,52,55,"Top 6","Not Top 6"
"Southampton","Burnley","Away","Pre",90,0,16,39,-20,45,65,15,40,-23,45,68,"Not Top 6","Not Top 6"
"Everton","Crystal Palace","Away","Pre",90,0,8,54,8,54,46,12,49,-2,51,53,"Not Top 6","Not Top 6"
"Brighton","Watford","Away","Pre",28,1,17,36,-25,35,60,11,50,-7,52,59,"Not Top 6","Not Top 6"
"Wolves","Leicester","Away","Pre",90,0,7,57,1,47,46,9,52,3,51,48,"Not Top 6","Not Top 6"
"Arsenal","Newcastle","Away","Pre",58,1,5,70,22,73,51,13,45,-6,42,48,"Top 6","Not Top 6"
"Chelsea","Man United","Away","Pre",90,0,3,72,24,63,39,6,66,11,65,54,"Top 6","Top 6"
"Burnley","Arsenal","Away","Pre",43,1,15,40,-23,45,68,5,70,22,73,51,"Not Top 6","Top 6"
"West Ham","Brighton","Away","Pre",61,1,10,52,-3,52,55,17,36,-25,35,60,"Not Top 6","Not Top 6"
"Watford","Everton","Away","Pre",90,0,11,50,-7,52,59,8,54,8,54,46,"Not Top 6","Not Top 6"
"Liverpool","Southampton","Away","Pre",45,1,2,97,67,89,22,16,39,-20,45,65,"Top 6","Not Top 6"
"Tottenham","Man City","Away","Pre",23,1,4,71,28,67,39,1,98,72,95,23,"Top 6","Top 6"
"Leicester","Chelsea","Away","Pre",67,1,9,52,3,51,48,3,72,24,63,39,"Not Top 6","Top 6"
"Man United","Wolves","Away","Pre",27,1,6,66,11,65,54,7,57,1,47,46,"Top 6","Not Top 6"
"Southampton","Brighton","Away","Pre",55,1,16,39,-20,45,65,17,36,-25,35,60,"Not Top 6","Not Top 6"
"Crystal Palace","Man United","Away","Pre",32,1,12,49,-2,51,53,6,66,11,65,54,"Not Top 6","Top 6"
"West Ham","Watford","Away","Pre",3,1,10,52,-3,52,55,11,50,-7,52,59,"Not Top 6","Not Top 6"
"Arsenal","Liverpool","Away","Pre",85,1,5,70,22,73,51,2,97,67,89,22,"Top 6","Top 6"
"Man City","Bournemouth","Away","Pre",15,1,1,98,72,95,23,14,45,-14,56,70,"Top 6","Not Top 6"
"Newcastle","Tottenham","Away","Pre",27,1,13,45,-6,42,48,4,71,28,67,39,"Not Top 6","Top 6"
"Burnley","Wolves","Away","Pre",13,1,15,40,-23,45,68,7,57,1,47,46,"Not Top 6","Not Top 6"
"Man United","Southampton","Away","Pre",10,1,6,66,11,65,54,16,39,-20,45,65,"Top 6","Not Top 6"
"Bournemouth","Leicester","Away","Pre",15,1,14,45,-14,56,70,9,52,3,51,48,"Not Top 6","Not Top 6"
"Brighton","Man City","Away","Pre",90,0,17,36,-25,35,60,1,98,72,95,23,"Not Top 6","Top 6"
"Watford","Newcastle","Away","Pre",2,1,11,50,-7,52,59,13,45,-6,42,48,"Not Top 6","Not Top 6"
"Liverpool","Burnley","Away","Pre",33,1,2,97,67,89,22,15,40,-23,45,68,"Top 6","Not Top 6"
"Wolves","Everton","Away","Pre",9,1,7,57,1,47,46,8,54,8,54,46,"Not Top 6","Not Top 6"
"Tottenham","Arsenal","Away","Pre",10,1,4,71,28,67,39,5,70,22,73,51,"Top 6","Top 6"
"Newcastle","Liverpool","Away","Pre",7,1,13,45,-6,42,48,2,97,67,89,22,"Not Top 6","Top 6"
"Burnley","Brighton","Away","Pre",90,1,15,40,-23,45,68,17,36,-25,35,60,"Not Top 6","Not Top 6"
"Leicester","Man United","Away","Pre",90,0,9,52,3,51,48,6,66,11,65,54,"Not Top 6","Top 6"
"Crystal Palace","Tottenham","Away","Pre",90,0,12,49,-2,51,53,4,71,28,67,39,"Not Top 6","Top 6"
"Chelsea","Wolves","Away","Pre",31,1,3,72,24,63,39,7,57,1,47,46,"Top 6","Not Top 6"
"Everton","Bournemouth","Away","Pre",44,1,8,54,8,54,46,14,45,-14,56,70,"Not Top 6","Not Top 6"
"Arsenal","Watford","Away","Pre",21,1,5,70,22,73,51,11,50,-7,52,59,"Top 6","Not Top 6"
"Bournemouth","Southampton","Away","Pre",10,1,14,45,-14,56,70,16,39,-20,45,65,"Not Top 6","Not Top 6"
"Tottenham","Leicester","Away","Pre",29,1,4,71,28,67,39,9,52,3,51,48,"Top 6","Not Top 6"
"Watford","Man City","Away","Pre",90,0,11,50,-7,52,59,1,98,72,95,23,"Not Top 6","Top 6"
"Brighton","Newcastle","Away","Pre",90,0,17,36,-25,35,60,13,45,-6,42,48,"Not Top 6","Not Top 6"
"Wolves","Crystal Palace","Away","Pre",90,1,7,57,1,47,46,12,49,-2,51,53,"Not Top 6","Not Top 6"
"Man United","West Ham","Away","Pre",90,0,6,66,11,65,54,10,52,-3,52,55,"Top 6","Not Top 6"
"Liverpool","Chelsea","Away","Pre",14,1,2,97,67,89,22,3,72,24,63,39,"Top 6","Top 6"
"West Ham","Bournemouth","Away","Pre",10,1,10,52,-3,52,55,14,45,-14,56,70,"Not Top 6","Not Top 6"
"Brighton","Chelsea","Away","Pre",90,0,17,36,-25,35,60,3,72,24,63,39,"Not Top 6","Top 6"
"Southampton","Tottenham","Away","Pre",39,1,16,39,-20,45,65,4,71,28,67,39,"Not Top 6","Top 6"
"Watford","Wolves","Away","Pre",90,0,11,50,-7,52,59,7,57,1,47,46,"Not Top 6","Not Top 6"
"Man City","Everton","Away","Pre",24,1,1,98,72,95,23,8,54,8,54,46,"Top 6","Not Top 6"
"Newcastle","Leicester","Away","Pre",90,0,13,45,-6,42,48,9,52,3,51,48,"Not Top 6","Not Top 6"
"Arsenal","Man United","Away","Pre",58,1,5,70,22,73,51,6,66,11,65,54,"Top 6","Top 6"
"Tottenham","Brighton","Away","Pre",90,0,4,71,28,67,39,17,36,-25,35,60,"Top 6","Not Top 6"
"Everton","Burnley","Away","Pre",90,0,8,54,8,54,46,15,40,-23,45,68,"Not Top 6","Not Top 6"
"Leicester","Liverpool","Away","Pre",80,1,9,52,3,51,48,2,97,67,89,22,"Not Top 6","Top 6"
"Crystal Palace","West Ham","Away","Pre",63,1,12,49,-2,51,53,10,52,-3,52,55,"Not Top 6","Not Top 6"
"Bournemouth","Arsenal","Away","Pre",90,0,14,45,-14,56,70,5,70,22,73,51,"Not Top 6","Top 6"
"Wolves","Man City","Away","Pre",80,1,7,57,1,47,46,1,98,72,95,23,"Not Top 6","Top 6"
"Chelsea","Southampton","Away","Pre",17,1,3,72,24,63,39,16,39,-20,45,65,"Top 6","Not Top 6"
"Man United","Newcastle","Away","Pre",90,0,6,66,11,65,54,13,45,-6,42,48,"Top 6","Not Top 6"
"West Ham","Everton","Away","Pre",90,0,10,52,-3,52,55,8,54,8,54,46,"Not Top 6","Not Top 6"
"Newcastle","Chelsea","Away","Pre",90,0,13,45,-6,42,48,3,72,24,63,39,"Not Top 6","Top 6"
"Burnley","Leicester","Away","Pre",26,1,15,40,-23,45,68,9,52,3,51,48,"Not Top 6","Not Top 6"
"Watford","Tottenham","Away","Pre",6,1,11,50,-7,52,59,4,71,28,67,39,"Not Top 6","Top 6"
"Southampton","Wolves","Away","Pre",53,1,16,39,-20,45,65,7,57,1,47,46,"Not Top 6","Not Top 6"
"Man City","Crystal Palace","Away","Pre",39,1,1,98,72,95,23,12,49,-2,51,53,"Top 6","Not Top 6"
"Liverpool","Man United","Away","Pre",85,1,2,97,67,89,22,6,66,11,65,54,"Top 6","Top 6"
"Leicester","Southampton","Away","Pre",10,1,9,52,3,51,48,16,39,-20,45,65,"Not Top 6","Not Top 6"
"Everton","Brighton","Away","Pre",20,1,8,54,8,54,46,17,36,-25,35,60,"Not Top 6","Not Top 6"
"Bournemouth","Watford","Away","Pre",90,0,14,45,-14,56,70,11,50,-7,52,59,"Not Top 6","Not Top 6"
"Chelsea","Burnley","Away","Pre",21,1,3,72,24,63,39,15,40,-23,45,68,"Top 6","Not Top 6"
"Wolves","Newcastle","Away","Pre",73,1,7,57,1,47,46,13,45,-6,42,48,"Not Top 6","Not Top 6"
"Crystal Palace","Arsenal","Away","Pre",32,1,12,49,-2,51,53,5,70,22,73,51,"Not Top 6","Top 6"
"Tottenham","Liverpool","Away","Pre",1,1,4,71,28,67,39,2,97,67,89,22,"Top 6","Top 6"
"Man United","Bournemouth","Away","Pre",90,0,6,66,11,65,54,14,45,-14,56,70,"Top 6","Not Top 6"
"Wolves","Arsenal","Away","Pre",76,1,7,57,1,47,46,5,70,22,73,51,"Not Top 6","Top 6"
"Southampton","Man City","Away","Pre",13,1,16,39,-20,45,65,1,98,72,95,23,"Not Top 6","Top 6"
"Newcastle","West Ham","Away","Pre",16,1,13,45,-6,42,48,10,52,-3,52,55,"Not Top 6","Not Top 6"
"Chelsea","Watford","Away","Pre",5,1,3,72,24,63,39,11,50,-7,52,59,"Top 6","Not Top 6"
"Leicester","Crystal Palace","Away","Pre",57,1,9,52,3,51,48,12,49,-2,51,53,"Not Top 6","Not Top 6"
"Tottenham","Everton","Away","Pre",63,1,4,71,28,67,39,8,54,8,54,46,"Top 6","Not Top 6"
"Crystal Palace","Chelsea","Away","Pre",90,0,12,49,-2,51,53,3,72,24,63,39,"Not Top 6","Top 6"
"West Ham","Burnley","Away","Pre",90,0,10,52,-3,52,55,15,40,-23,45,68,"Not Top 6","Not Top 6"
"Bournemouth","Newcastle","Away","Pre",14,1,14,45,-14,56,70,13,45,-6,42,48,"Not Top 6","Not Top 6"
"Everton","Southampton","Away","Pre",4,1,8,54,8,54,46,16,39,-20,45,65,"Not Top 6","Not Top 6"
"Arsenal","Leicester","Away","Pre",90,0,5,70,22,73,51,9,52,3,51,48,"Top 6","Not Top 6"
"Brighton","Man United","Away","Pre",64,1,17,36,-25,35,60,6,66,11,65,54,"Not Top 6","Top 6"
"Man City","Liverpool","Away","Pre",78,1,1,98,72,95,23,2,97,67,89,22,"Top 6","Top 6"
"Tottenham","West Ham","Away","Pre",36,1,4,71,28,67,39,10,52,-3,52,55,"Top 6","Not Top 6"
"Southampton","Arsenal","Away","Pre",8,1,16,39,-20,45,65,5,70,22,73,51,"Not Top 6","Top 6"
"Wolves","Bournemouth","Away","Pre",21,1,7,57,1,47,46,14,45,-14,56,70,"Not Top 6","Not Top 6"
"Leicester","Brighton","Away","Pre",64,1,9,52,3,51,48,17,36,-25,35,60,"Not Top 6","Not Top 6"
"Liverpool","Crystal Palace","Away","Pre",49,1,2,97,67,89,22,12,49,-2,51,53,"Top 6","Not Top 6"
"Burnley","Watford","Away","Pre",53,1,15,40,-23,45,68,11,50,-7,52,59,"Not Top 6","Not Top 6"
"Chelsea","Man City","Away","Pre",21,1,3,72,24,63,39,1,98,72,95,23,"Top 6","Top 6"
"Man City","Newcastle","Away","Pre",22,1,1,98,72,95,23,13,45,-6,42,48,"Top 6","Not Top 6"
"Crystal Palace","Burnley","Away","Pre",45,1,12,49,-2,51,53,15,40,-23,45,68,"Not Top 6","Not Top 6"
"West Ham","Chelsea","Away","Pre",48,1,10,52,-3,52,55,3,72,24,63,39,"Not Top 6","Top 6"
"Brighton","Liverpool","Away","Pre",79,1,17,36,-25,35,60,2,97,67,89,22,"Not Top 6","Top 6"
"Bournemouth","Tottenham","Away","Pre",73,1,14,45,-14,56,70,4,71,28,67,39,"Not Top 6","Top 6"
"Watford","Southampton","Away","Pre",24,1,11,50,-7,52,59,16,39,-20,45,65,"Not Top 6","Not Top 6"
"Everton","Leicester","Away","Pre",23,1,8,54,8,54,46,9,52,3,51,48,"Not Top 6","Not Top 6"
"Bournemouth","Crystal Palace","Away","Pre",90,0,14,45,-14,56,70,12,49,-2,51,53,"Not Top 6","Not Top 6"
"Man City","Burnley","Away","Pre",24,1,1,98,72,95,23,15,40,-23,45,68,"Top 6","Not Top 6"
"Watford","Leicester","Away","Pre",90,0,11,50,-7,52,59,9,52,3,51,48,"Not Top 6","Not Top 6"
"Tottenham","Man United","Away","Pre",39,1,4,71,28,67,39,6,66,11,65,54,"Top 6","Top 6"
"West Ham","Wolves","Away","Pre",90,0,10,52,-3,52,55,7,57,1,47,46,"Not Top 6","Not Top 6"
"Everton","Liverpool","Away","Pre",21,1,8,54,8,54,46,2,97,67,89,22,"Not Top 6","Top 6"
"Brighton","Arsenal","Away","Pre",36,1,17,36,-25,35,60,5,70,22,73,51,"Not Top 6","Top 6"
"Chelsea","Everton","Away","Pre",52,1,3,72,24,63,39,8,54,8,54,46,"Top 6","Not Top 6"
"Liverpool","Bournemouth","Away","Pre",35,1,2,97,67,89,22,14,45,-14,56,70,"Top 6","Not Top 6"
"Burnley","Tottenham","Away","Pre",90,0,15,40,-23,45,68,4,71,28,67,39,"Not Top 6","Top 6"
"Crystal Palace","Watford","Away","Pre",90,0,12,49,-2,51,53,11,50,-7,52,59,"Not Top 6","Not Top 6"
"Man United","Man City","Away","Pre",23,1,6,66,11,65,54,1,98,72,95,23,"Top 6","Top 6"
"Southampton","Newcastle","Away","Pre",52,1,16,39,-20,45,65,13,45,-6,42,48,"Not Top 6","Not Top 6"
"Wolves","Brighton","Away","Pre",28,1,7,57,1,47,46,17,36,-25,35,60,"Not Top 6","Not Top 6"
"Arsenal","West Ham","Away","Pre",60,1,5,70,22,73,51,10,52,-3,52,55,"Top 6","Not Top 6"
"Watford","Liverpool","Away","Pre",90,0,11,50,-7,52,59,2,97,67,89,22,"Not Top 6","Top 6"
"Newcastle","Burnley","Away","Pre",90,0,13,45,-6,42,48,15,40,-23,45,68,"Not Top 6","Not Top 6"
"Bournemouth","Chelsea","Away","Pre",84,1,14,45,-14,56,70,3,72,24,63,39,"Not Top 6","Top 6"
"West Ham","Southampton","Away","Pre",37,1,10,52,-3,52,55,16,39,-20,45,65,"Not Top 6","Not Top 6"
"Everton","Man United","Away","Pre",36,1,8,54,8,54,46,6,66,11,65,54,"Not Top 6","Top 6"
"Tottenham","Wolves","Away","Pre",8,1,4,71,28,67,39,7,57,1,47,46,"Top 6","Not Top 6"
"Man City","Arsenal","Away","Pre",2,1,1,98,72,95,23,5,70,22,73,51,"Top 6","Top 6"
"Brighton","Crystal Palace","Away","Pre",54,1,17,36,-25,35,60,12,49,-2,51,53,"Not Top 6","Not Top 6"
"Arsenal","Everton","Away","Pre",90,0,5,70,22,73,51,8,54,8,54,46,"Top 6","Not Top 6"
"Burnley","Bournemouth","Away","Pre",89,1,15,40,-23,45,68,14,45,-14,56,70,"Not Top 6","Not Top 6"
"Crystal Palace","Newcastle","Away","Pre",90,0,12,49,-2,51,53,13,45,-6,42,48,"Not Top 6","Not Top 6"
"Leicester","Man City","Away","Pre",22,1,9,52,3,51,48,1,98,72,95,23,"Not Top 6","Top 6"
"Man United","Watford","Away","Pre",90,0,6,66,11,65,54,11,50,-7,52,59,"Top 6","Not Top 6"
"Chelsea","Tottenham","Away","Pre",12,1,3,72,24,63,39,4,71,28,67,39,"Top 6","Top 6"
"Brighton","Tottenham","Away","Pre",37,1,17,36,-25,35,60,4,71,28,67,39,"Not Top 6","Top 6"
"Arsenal","Bournemouth","Away","Pre",63,1,5,70,22,73,51,14,45,-14,56,70,"Top 6","Not Top 6"
"Southampton","Chelsea","Away","Pre",31,1,16,39,-20,45,65,3,72,24,63,39,"Not Top 6","Top 6"
"West Ham","Crystal Palace","Away","Pre",57,1,10,52,-3,52,55,12,49,-2,51,53,"Not Top 6","Not Top 6"
"Burnley","Everton","Away","Pre",90,0,15,40,-23,45,68,8,54,8,54,46,"Not Top 6","Not Top 6"
"Newcastle","Man United","Away","Pre",17,1,13,45,-6,42,48,6,66,11,65,54,"Not Top 6","Top 6"
"Liverpool","Leicester","Away","Pre",31,1,2,97,67,89,22,9,52,3,51,48,"Top 6","Not Top 6"
"Man City","Wolves","Away","Pre",25,1,1,98,72,95,23,7,57,1,47,46,"Top 6","Not Top 6"
"Bournemouth","Brighton","Away","Pre",90,0,14,45,-14,56,70,17,36,-25,35,60,"Not Top 6","Not Top 6"
"Everton","Newcastle","Away","Pre",13,1,8,54,8,54,46,13,45,-6,42,48,"Not Top 6","Not Top 6"
"Crystal Palace","Southampton","Away","Pre",50,1,12,49,-2,51,53,16,39,-20,45,65,"Not Top 6","Not Top 6"
"Leicester","West Ham","Away","Pre",40,1,9,52,3,51,48,10,52,-3,52,55,"Not Top 6","Not Top 6"
"Man United","Burnley","Away","Pre",44,1,6,66,11,65,54,15,40,-23,45,68,"Top 6","Not Top 6"
"Chelsea","Arsenal","Away","Pre",83,1,3,72,24,63,39,5,70,22,73,51,"Top 6","Top 6"
"Wolves","Liverpool","Away","Pre",90,0,7,57,1,47,46,2,97,67,89,22,"Not Top 6","Top 6"
"Chelsea","Brighton","Away","Pre",10,1,3,72,24,63,39,17,36,-25,35,60,"Top 6","Not Top 6"
"Leicester","Newcastle","Away","Pre",36,1,9,52,3,51,48,13,45,-6,42,48,"Not Top 6","Not Top 6"
"Tottenham","Southampton","Away","Pre",90,0,4,71,28,67,39,16,39,-20,45,65,"Top 6","Not Top 6"
"Wolves","Watford","Away","Pre",60,1,7,57,1,47,46,11,50,-7,52,59,"Not Top 6","Not Top 6"
"Everton","Man City","Away","Pre",71,1,8,54,8,54,46,1,98,72,95,23,"Not Top 6","Top 6"
"Bournemouth","West Ham","Away","Pre",90,0,14,45,-14,56,70,10,52,-3,52,55,"Not Top 6","Not Top 6"
"Man United","Arsenal","Away","Pre",90,0,6,66,11,65,54,5,70,22,73,51,"Top 6","Top 6"
"Arsenal","Crystal Palace","Away","Pre",12,1,5,70,22,73,51,12,49,-2,51,53,"Top 6","Not Top 6"
"Burnley","Chelsea","Away","Pre",90,0,15,40,-23,45,68,3,72,24,63,39,"Not Top 6","Top 6"
"Brighton","Everton","Away","Pre",90,0,17,36,-25,35,60,8,54,8,54,46,"Not Top 6","Not Top 6"
"Southampton","Leicester","Away","Pre",19,1,16,39,-20,45,65,9,52,3,51,48,"Not Top 6","Not Top 6"
"Newcastle","Wolves","Away","Pre",7,1,13,45,-6,42,48,7,57,1,47,46,"Not Top 6","Not Top 6"
"Liverpool","Tottenham","Away","Pre",37,1,2,97,67,89,22,4,71,28,67,39,"Top 6","Top 6"
"Watford","Bournemouth","Away","Pre",42,1,11,50,-7,52,59,14,45,-14,56,70,"Not Top 6","Not Top 6"
"Tottenham","Watford","Away","Pre",90,0,4,71,28,67,39,11,50,-7,52,59,"Top 6","Not Top 6"
"Crystal Palace","Man City","Away","Pre",39,1,12,49,-2,51,53,1,98,72,95,23,"Not Top 6","Top 6"
"Wolves","Southampton","Away","Pre",53,1,7,57,1,47,46,16,39,-20,45,65,"Not Top 6","Not Top 6"
"Everton","West Ham","Away","Pre",44,1,8,54,8,54,46,10,52,-3,52,55,"Not Top 6","Not Top 6"
"Chelsea","Newcastle","Away","Pre",90,0,3,72,24,63,39,13,45,-6,42,48,"Top 6","Not Top 6"
"Leicester","Burnley","Away","Pre",33,1,9,52,3,51,48,15,40,-23,45,68,"Not Top 6","Not Top 6"
"Man United","Liverpool","Away","Pre",90,0,6,66,11,65,54,2,97,67,89,22,"Top 6","Top 6"
"Brighton","Bournemouth","Away","Pre",81,1,17,36,-25,35,60,14,45,-14,56,70,"Not Top 6","Not Top 6"
"Southampton","Crystal Palace","Away","Pre",22,1,16,39,-20,45,65,12,49,-2,51,53,"Not Top 6","Not Top 6"
"Newcastle","Everton","Away","Pre",90,1,13,45,-6,42,48,8,54,8,54,46,"Not Top 6","Not Top 6"
"Arsenal","Chelsea","Away","Pre",63,1,5,70,22,73,51,3,72,24,63,39,"Top 6","Top 6"
"West Ham","Leicester","Away","Pre",50,1,10,52,-3,52,55,9,52,3,51,48,"Not Top 6","Not Top 6"
"Burnley","Man United","Away","Pre",39,1,15,40,-23,45,68,6,66,11,65,54,"Not Top 6","Top 6"
"Liverpool","Wolves","Away","Pre",8,1,2,97,67,89,22,7,57,1,47,46,"Top 6","Not Top 6"
"Liverpool","West Ham","Away","Pre",35,1,2,97,67,89,22,10,52,-3,52,55,"Top 6","Not Top 6"
"Chelsea","Leicester","Away","Pre",46,1,3,72,24,63,39,9,52,3,51,48,"Top 6","Not Top 6"
"Southampton","Liverpool","Away","Pre",90,0,16,39,-20,45,65,2,97,67,89,22,"Not Top 6","Top 6"
"Everton","Watford","Away","Pre",45,1,8,54,8,54,46,11,50,-7,52,59,"Not Top 6","Not Top 6"
"Brighton","West Ham","Away","Pre",47,1,17,36,-25,35,60,10,52,-3,52,55,"Not Top 6","Not Top 6"
"Wolves","Man United","Away","Pre",90,0,7,57,1,47,46,6,66,11,65,54,"Not Top 6","Top 6"
"Arsenal","Burnley","Away","Pre",90,0,5,70,22,73,51,15,40,-23,45,68,"Top 6","Not Top 6"
"Man City","Tottenham","Away","Pre",90,0,1,98,72,95,23,4,71,28,67,39,"Top 6","Top 6"
"Crystal Palace","Everton","Away","Pre",51,1,12,49,-2,51,53,8,54,8,54,46,"Not Top 6","Not Top 6"
"Watford","Brighton","Away","Pre",19,1,11,50,-7,52,59,17,36,-25,35,60,"Not Top 6","Not Top 6"
"Leicester","Wolves","Away","Pre",90,0,9,52,3,51,48,7,57,1,47,46,"Not Top 6","Not Top 6"
"Burnley","Southampton","Away","Pre",2,1,15,40,-23,45,68,16,39,-20,45,65,"Not Top 6","Not Top 6"
"Newcastle","Arsenal","Away","Pre",90,0,13,45,-6,42,48,5,70,22,73,51,"Not Top 6","Top 6"
"Man United","Chelsea","Away","Pre",45,1,6,66,11,65,54,3,72,24,63,39,"Top 6","Top 6"
"West Ham","Man City","Away","Pre",90,0,10,52,-3,52,55,1,98,72,95,23,"Not Top 6","Top 6"
"Tottenham","Chelsea","Away","Pre",89,1,4,71,28,67,39,3,72,24,63,39,"Top 6","Top 6"
"Bournemouth","Burnley","Away","Pre",90,0,14,45,-14,56,70,15,40,-23,45,68,"Not Top 6","Not Top 6"
"Newcastle","Crystal Palace","Away","Pre",90,0,13,45,-6,42,48,12,49,-2,51,53,"Not Top 6","Not Top 6"
"Man City","Leicester","Away","Pre",80,1,1,98,72,95,23,9,52,3,51,48,"Top 6","Not Top 6"
"Watford","Man United","Away","Pre",90,0,11,50,-7,52,59,6,66,11,65,54,"Not Top 6","Top 6"
"Everton","Arsenal","Away","Pre",1,1,8,54,8,54,46,5,70,22,73,51,"Not Top 6","Top 6"
"West Ham","Liverpool","Away","Pre",12,1,10,52,-3,52,55,2,97,67,89,22,"Not Top 6","Top 6"
"Crystal Palace","Brighton","Away","Pre",70,1,12,49,-2,51,53,17,36,-25,35,60,"Not Top 6","Not Top 6"
"Chelsea","Bournemouth","Away","Pre",33,1,3,72,24,63,39,14,45,-14,56,70,"Top 6","Not Top 6"
"Burnley","Newcastle","Away","Pre",90,0,15,40,-23,45,68,13,45,-6,42,48,"Not Top 6","Not Top 6"
"Southampton","West Ham","Away","Pre",31,1,16,39,-20,45,65,10,52,-3,52,55,"Not Top 6","Not Top 6"
"Liverpool","Watford","Away","Pre",90,0,2,97,67,89,22,11,50,-7,52,59,"Top 6","Not Top 6"
"Man United","Everton","Away","Pre",31,1,6,66,11,65,54,8,54,8,54,46,"Top 6","Not Top 6"
"Wolves","Tottenham","Away","Pre",27,1,7,57,1,47,46,4,71,28,67,39,"Not Top 6","Top 6"
"Bournemouth","Liverpool","Away","Pre",9,1,14,45,-14,56,70,2,97,67,89,22,"Not Top 6","Top 6"
"West Ham","Arsenal","Away","Pre",90,0,10,52,-3,52,55,5,70,22,73,51,"Not Top 6","Top 6"
"Watford","Crystal Palace","Away","Pre",90,0,11,50,-7,52,59,12,49,-2,51,53,"Not Top 6","Not Top 6"
"Newcastle","Southampton","Away","Pre",79,1,13,45,-6,42,48,16,39,-20,45,65,"Not Top 6","Not Top 6"
"Brighton","Wolves","Away","Pre",90,0,17,36,-25,35,60,7,57,1,47,46,"Not Top 6","Not Top 6"
"Tottenham","Burnley","Away","Pre",50,1,4,71,28,67,39,15,40,-23,45,68,"Top 6","Not Top 6"
"Everton","Chelsea","Away","Pre",90,0,8,54,8,54,46,3,72,24,63,39,"Not Top 6","Top 6"
"Man City","Man United","Away","Pre",90,0,1,98,72,95,23,6,66,11,65,54,"Top 6","Top 6"
"Arsenal","Man City","Away","Post",90,0,5,70,22,73,51,1,98,72,95,23,"Top 6","Top 6"
"Man United","Tottenham","Away","Post",81,1,6,66,11,65,54,4,71,28,67,39,"Top 6","Top 6"
"Leicester","Watford","Away","Post",90,1,9,52,3,51,48,11,50,-7,52,59,"Not Top 6","Not Top 6"
"Arsenal","Brighton","Away","Post",68,1,5,70,22,73,51,17,36,-25,35,60,"Top 6","Not Top 6"
"Wolves","West Ham","Away","Post",73,1,7,57,1,47,46,10,52,-3,52,55,"Not Top 6","Not Top 6"
"Crystal Palace","Bournemouth","Away","Post",12,1,12,49,-2,51,53,14,45,-14,56,70,"Not Top 6","Not Top 6"
"Liverpool","Everton","Away","Post",90,0,2,97,67,89,22,8,54,8,54,46,"Top 6","Not Top 6"
"Burnley","Man City","Away","Post",90,0,15,40,-23,45,68,1,98,72,95,23,"Not Top 6","Top 6"
"Brighton","Leicester","Away","Post",90,0,17,36,-25,35,60,9,52,3,51,48,"Not Top 6","Not Top 6"
"West Ham","Tottenham","Away","Post",90,0,10,52,-3,52,55,4,71,28,67,39,"Not Top 6","Top 6"
"Bournemouth","Wolves","Away","Post",90,0,14,45,-14,56,70,7,57,1,47,46,"Not Top 6","Not Top 6"
"Crystal Palace","Liverpool","Away","Post",90,0,12,49,-2,51,53,2,97,67,89,22,"Not Top 6","Top 6"
"Watford","Burnley","Away","Post",90,0,11,50,-7,52,59,15,40,-23,45,68,"Not Top 6","Not Top 6"
"Arsenal","Southampton","Away","Post",20,1,5,70,22,73,51,16,39,-20,45,65,"Top 6","Not Top 6"
"Man City","Chelsea","Away","Post",55,1,1,98,72,95,23,3,72,24,63,39,"Top 6","Top 6"
"Southampton","Watford","Away","Post",16,1,16,39,-20,45,65,11,50,-7,52,59,"Not Top 6","Not Top 6"
"Burnley","Crystal Palace","Away","Post",62,1,15,40,-23,45,68,12,49,-2,51,53,"Not Top 6","Not Top 6"
"Man United","Brighton","Away","Post",16,1,6,66,11,65,54,17,36,-25,35,60,"Top 6","Not Top 6"
"Newcastle","Bournemouth","Away","Post",5,1,13,45,-6,42,48,14,45,-14,56,70,"Not Top 6","Not Top 6"
"Leicester","Everton","Away","Post",51,1,9,52,3,51,48,8,54,8,54,46,"Not Top 6","Not Top 6"
"Chelsea","West Ham","Away","Post",42,1,3,72,24,63,39,10,52,-3,52,55,"Top 6","Not Top 6"
"Liverpool","Man City","Away","Post",90,0,2,97,67,89,22,1,98,72,95,23,"Top 6","Top 6"
"Crystal Palace","Leicester","Away","Post",90,0,12,49,-2,51,53,9,52,3,51,48,"Not Top 6","Not Top 6"
"Bournemouth","Man United","Away","Post",15,1,14,45,-14,56,70,6,66,11,65,54,"Not Top 6","Top 6"
"Arsenal","Wolves","Away","Post",43,1,5,70,22,73,51,7,57,1,47,46,"Top 6","Not Top 6"
"Watford","Chelsea","Away","Post",90,0,11,50,-7,52,59,3,72,24,63,39,"Not Top 6","Top 6"
"West Ham","Newcastle","Away","Post",4,1,10,52,-3,52,55,13,45,-6,42,48,"Not Top 6","Not Top 6"
"Man City","Southampton","Away","Post",90,0,1,98,72,95,23,16,39,-20,45,65,"Top 6","Not Top 6"
"Everton","Tottenham","Away","Post",90,0,8,54,8,54,46,4,71,28,67,39,"Not Top 6","Top 6"
"Chelsea","Crystal Palace","Away","Post",6,1,3,72,24,63,39,12,49,-2,51,53,"Top 6","Not Top 6"
"Leicester","Arsenal","Away","Post",84,1,9,52,3,51,48,5,70,22,73,51,"Not Top 6","Top 6"
"Newcastle","Man City","Away","Post",90,0,13,45,-6,42,48,1,98,72,95,23,"Not Top 6","Top 6"
"Burnley","West Ham","Away","Post",38,1,15,40,-23,45,68,10,52,-3,52,55,"Not Top 6","Not Top 6"
"Liverpool","Brighton","Away","Post",6,1,2,97,67,89,22,17,36,-25,35,60,"Top 6","Not Top 6"
"Tottenham","Bournemouth","Away","Post",90,0,4,71,28,67,39,14,45,-14,56,70,"Top 6","Not Top 6"
"Southampton","Everton","Away","Post",31,1,16,39,-20,45,65,8,54,8,54,46,"Not Top 6","Not Top 6"
"Newcastle","Watford","Away","Post",23,1,13,45,-6,42,48,11,50,-7,52,59,"Not Top 6","Not Top 6"
"Burnley","Liverpool","Away","Post",69,1,15,40,-23,45,68,2,97,67,89,22,"Not Top 6","Top 6"
"Man City","Brighton","Away","Post",21,1,1,98,72,95,23,17,36,-25,35,60,"Top 6","Not Top 6"
"Everton","Wolves","Away","Post",90,0,8,54,8,54,46,7,57,1,47,46,"Not Top 6","Not Top 6"
"Arsenal","Tottenham","Away","Post",16,1,5,70,22,73,51,4,71,28,67,39,"Top 6","Top 6"
"Leicester","Bournemouth","Away","Post",23,1,9,52,3,51,48,14,45,-14,56,70,"Not Top 6","Not Top 6"
"Southampton","Man United","Away","Post",12,1,16,39,-20,45,65,6,66,11,65,54,"Not Top 6","Top 6"
"Wolves","Burnley","Away","Post",76,1,7,57,1,47,46,15,40,-23,45,68,"Not Top 6","Not Top 6"
"Bournemouth","Man City","Away","Post",88,1,14,45,-14,56,70,1,98,72,95,23,"Not Top 6","Top 6"
"Tottenham","Newcastle","Away","Post",27,1,4,71,28,67,39,13,45,-6,42,48,"Top 6","Not Top 6"
"Liverpool","Arsenal","Away","Post",20,1,2,97,67,89,22,5,70,22,73,51,"Top 6","Top 6"
"Man United","Crystal Palace","Away","Post",45,1,6,66,11,65,54,12,49,-2,51,53,"Top 6","Not Top 6"
"Brighton","Southampton","Away","Post",17,1,17,36,-25,35,60,16,39,-20,45,65,"Not Top 6","Not Top 6"
"Watford","West Ham","Away","Post",49,1,11,50,-7,52,59,10,52,-3,52,55,"Not Top 6","Not Top 6"
"Southampton","Bournemouth","Away","Post",41,1,16,39,-20,45,65,14,45,-14,56,70,"Not Top 6","Not Top 6"
"Leicester","Tottenham","Away","Post",90,0,9,52,3,51,48,4,71,28,67,39,"Not Top 6","Top 6"
"Newcastle","Brighton","Away","Post",90,0,13,45,-6,42,48,17,36,-25,35,60,"Not Top 6","Not Top 6"
"Crystal Palace","Wolves","Away","Post",90,0,12,49,-2,51,53,7,57,1,47,46,"Not Top 6","Not Top 6"
"Man City","Watford","Away","Post",31,1,1,98,72,95,23,11,50,-7,52,59,"Top 6","Not Top 6"
"West Ham","Man United","Away","Post",45,1,10,52,-3,52,55,6,66,11,65,54,"Not Top 6","Top 6"
"Chelsea","Liverpool","Away","Post",45,1,3,72,24,63,39,2,97,67,89,22,"Top 6","Top 6"
"Watford","Arsenal","Away","Post",43,1,11,50,-7,52,59,5,70,22,73,51,"Not Top 6","Top 6"
"Brighton","Burnley","Away","Post",20,1,17,36,-25,35,60,15,40,-23,45,68,"Not Top 6","Not Top 6"
"Wolves","Chelsea","Away","Post",90,0,7,57,1,47,46,3,72,24,63,39,"Not Top 6","Top 6"
"Tottenham","Crystal Palace","Away","Post",13,1,4,71,28,67,39,12,49,-2,51,53,"Top 6","Not Top 6"
"Bournemouth","Everton","Away","Post",13,1,14,45,-14,56,70,8,54,8,54,46,"Not Top 6","Not Top 6"
"Man United","Leicester","Away","Post",71,1,6,66,11,65,54,9,52,3,51,48,"Top 6","Not Top 6"
"Liverpool","Newcastle","Away","Post",38,1,2,97,67,89,22,13,45,-6,42,48,"Top 6","Not Top 6"
